NO ./path_to_the_north_texture.xpm
SO ./path_to_the_south_texture.xpm
WE ./path_to_the_west_texture.xpm
EA ./path_to_the_east_texture.xpm

C 225,30,15
F 220,100,2



1111111111111111111111111111
1110111111111011100000010001
1111011111111101110101001001
1100000011010101110000000001
10000000N0000110000001000111
1000000000000000111101001001
1100000111010101110101111011
11110111 1110101 10111101001
11111111 1111111 11111111111
