C 100,149,127
F 244,164,96


NO ./stone.xpm
SO ./stonem.xpm
WE ./cobblem.xpm
EA ./cobblestone.xpm




1111111111111111111111111111
1000000000110111000000100111
1100000000001101110101001001
1000000000000000000000000001
1000000000000000000000000111
1000000000000000110000000011
1000000000011111000000000001
1000000000000000000000000001
1000000000000000000000000011
1000000000000000000000000001
1000000000000000000000000011
1000000000001000000000001111
1111111111111111111111101111
10000000000000000000000000E1
1111111111111111111111111111
11111111 1111111111111111111