C 100,149,227
F 244,164,96


NO ./textures/wallb.xpm
SO ./textures/stonem.xpm
WE ./textures/cobblem.xpm
EA ./textures/cobblestone.xpm




1111111111111111111111111111
1000000000110111000000100111
1100000000001101110101001001
1000000000000000000000000001
1000000000000000000000000111
1000000000000000110000000011
1000000000011111000010000001
10000000000000000000000000011111
100000000000000000000S0000000001
10000000000000000000000000011111
1000000000000000000000000011
1000000000001000000000001111
1111111111111111111111101111
1000000000000000000000000001
1111111111111111111111111111
11111111 1111111111111111111