C 100,149,254
F 105,25,153


NO ./textures/NO.xpm
SO ./textures/SO.xpm
WE ./textures/WE.xpm
EA ./textures/EA.xpm




1111111111111111111111111111
1000000000110111000000100111
100000000001101110101001001
100000000000000000000000001
100000000000W000000000000111
1000000000000000110000000011
100000000001111100001000111
100000000000000000000000000111111
11111111111111111111110000000001
1                     10000011111
1111111111111111111111100011
100000000000100000111101111
111111111111111111    1111111
10000000000000001
111111111111111111
11111111 1111111111111