C 100,149,254
F 122,193,147


NO ./textures/cobblestone.xpm
SO ./textures/cobblem.xpm
WE ./textures/stone.xpm
EA ./textures/stonem.xpm


1111111111111111111111111111
1000000000110111000000000111
10000000000110111010000001
1E0000000001000000000000001
100000000001111100000000001
100000000000000000000000001
100000000000000000000000001
111111111111111111111111111