C 211,150,200
F 170,100,220


NO ./download.xpm
SO ./path_to_the_south_texture.xpm
WE ./path_to_the_west_texture.xpm
EA ./path_to_the_east_texture.xpm




1111111111111111111111111111
1000000000110111000000100111
1100000000001101110101001001
1000000000000000000000000001
1000000000000000000000000111
1000000000000000110000000011
1000000000011111000000000001
1000000000000000000000000001
1000000000000000000000000011
1000000000000000000000000001
1000000000000000000000N00001
1000000000001000000000001111
1111111111111111111111101111
1000000000000000000000000001
1111111111111111111111111111
11111111 1111111 11111111111