NO ./path_to_the_north_texture.xpm
SO ./path_to_the_south_texture.xpm
WE ./path_to_the_west_texture.xpm
EA ./heap.xpm

C 225,30,2
F 220,100,2



        111111111111 11111111111111111111111
        100000000011 100000000001
        1011000001 11S0000000001
        1001000001 10000000000001
11111111011000001110000000000001
10000000011000001110111111111111
11110111111111011100000010101
11110111111111011101010010001
11000000110101011100000010001 111
10000000000000110000010001111111
1111000000000000001101010010001
11  111111100000111010101111101111111
11110111 1110101 1011110100011  1
11111111111111111111111111111111111