C 211,150,200
F 170,100,220


NO ./path_to_the_north_texture.xpm
SO ./path_to_the_south_texture.xpm
WE ./path_to_the_west_texture.xpm
EA ./path_to_the_east_texture.xpm




1111111111111111111111111111
1100000000110111000000100111
1100000000001101110101001001
1000000000000000000000000001
1000000000000000000000000111
100000000000000011000W000011
1000000000011111000000000001
1000000000000000000000000001
1000000000000000000000000011
1000000000000000000000000001
1000000000000000000000000001
1000000000001000000000001111
1111110111111000000000100001
1100000000000001111111011111
1111011111110101 10111100001
11111111 1111111 11111111111