NO ./path_to_the_north_texture.xpm
SO ./path_to_the_south_texture.xpm
WE ./path_to_the_west_texture.xpm
EA ./heap.xpm

F 220,100,2
C 225,30,2



        111111111111 111111111111
        1000000000111000000000001
        1011000001 10S0000000001
        1001000001 10000000000001
11111111011000001110000000000001
10000000011000001110111111111111
11110111111111011100000010101
11110111111111011101010010001
11000000110101011100000010001 111
10000000000000110000010001111111
1000000000000001101010010001
110000011101010111110111100111
11110111 1110101 101111010001  1
111111111111111111111111111111111111