NO ./path_to_the_north_texture.xpm
SO ./path_to_the_south_texture.xpm
WE ./path_to_the_west_texture.xpm
EA ./path_to_the_east_texture.xpm

C 225,30,15
F 220,100,2



1111111111111111111111111111
1110111111111011100000010001
11110111111111011101010010001
1100000011010101110000000001
10000000N00001100000010001111
10000000000000001111010010001
11000001110101011101011110111
11110111 1110101 101111010001
11111111 1111111 111111111111
