C 100,149,254
F 32,178,170


NO ./textures/mo4.xpm
SO ./textures/m08.xpm
WE ./textures/mo7.xpm
EA ./textures/mo10.xpm




1111111111111111111111111111
1000000000110111000000100111
1100000000001101110101001001
1000000000000000000000000001
1000000000000000000000000111
1000000000000000110000000011
1000000000011111000010000001
10000000000000000000000000011111
1111111111111111111111N0000000001
1                     10000011111
1111111111111111111111100011
100000000000100000111101111
111111111111111111    1111111          11
10000000000000001
111111111111111111
11111111 1111111111111