NO ./path_to_the_north_texture.xpm
SO ./path_to_the_south_texture.xpm
WE ./path_to_the_west_texture.xpm
EA ./path_to_the_east_texture.xpm

C 225,30,15
F 220,100,2



1111111111111111111111111111
1101111100110111000000100001
1100000000001101110101001001
1101100000000000000000000001
1000000000000000000000001111
1000000N0000000000000010001
110000000000001110111101111
1111011111110101 10111101001
11111111 1111111 11111111111
