C 112,128,144
F 47,79,79


NO ./textures/NO.xpm
SO ./textures/SO.xpm
WE ./textures/WE.xpm
EA ./textures/EA.xpm


1111111111111111111111111111
1000000000110111000000000111
10000000000110111010000001
1E0000000001000000000000001
100000000001111100000000001
100000000000000000000000001
100000000000000000000000001
111111111111111111111111111