F 112,128,144
C 47,79,90

EA     ./textures/EA.xpm
NO    ./textures/NO.xpm
SO     ./textures/SO.xpm
WE      ./textures/WE.xpm

111111111 111111111111111
100000001 110111000000000111
10000000010110111010000001
1111000000100000000000000111
    110000000000000000000111111 11111
      100000000000N000000011111111111
11111110000011111000000011
10000000000000000000000001
10000000000000100000000001
11111111111111111111111111
