F 112,128,144
C 47,79,245

NO    ./textures/NO.xpm
SO     ./textures/SO.xpm
WE      ./textures/WE.xpm
EA       ./textures/EA.xpm

 111111111111111111111111111111
1000000000110111000000000111
10000000000110111010000001
1111000000100000000000000111
    110000000000000000000111111 11111
      1000000000000000000011111111111
11111110000011111000000011
1000000000000000000000N0001
10000000000000100000000001
11111111111111111111111111