F 112,128,144
C 47,79,245

NO    ./textures/NO.xpm
SO     ./textures/SO.xpm
WE      ./textures/WE.xpm
EA        ./textures/EA.xpm

1111111111111111111
1000000000110111001
1000000000000011101
1111000000100000001
1100000000000000001
10000000N0000000001
1111111111111111111
